

Polski
[Audio]
+1 = +1
-1 = -1
Audio Settings = Ustawienia dźwięku
Auto = Auto
BGM Volume : = Gł. muzyki :
Enable Atrac3+ = Włącz Atrac3+
Enable Sound = Włącz dźwięk
SE Volume     : = Gł. efektów     :
[Developer]
Developer Tools = Zaawansowane
Dump next frame = Zrzuć nast. frame
Load language ini = Załaduj język
Report = Włącz raporty kompatybilności
Run CPU Tests = Testuj CPU
Save language ini = Zapisz język
[General]
Back = Wstecz
Next Page = Nast. strona
Prev Page = Pop. strona
[Graphics]
AA = Anti-Aliasing
Buffered Rendering = Buforowane rysowane
Display Raw Framebuffer = Rysuj czysty bufor klatek
Fullscreen = Pełny ekran
Graphics Settings = Ustawienia grafiki
Hardware Transform = Sprzętowe przetwarzanie geometrii
Mipmapping = Mipmapowanie
Skip Updating PSP Memory = Pomiń aktualizowanie pamięci PSP
Stream VBO = Strumieniuj VBO
VSync = VSync
Vertex Cache = Vertex cache
Anisotropic Filtering = Filtrowanie anizotropowe
Level : = Poziom : 
Texture Filtering = Filtrowanie tekstur
Type : = Typ : 
Nearest = Nearest
Linear = Liniowe
Linear(CG) = Liniowe(CG)
Texture Scaling = Skalowanie tekstur
Force 60 FPS or less = Wymuś limit 60 FPS lub mniej
Show speed / internal FPS = Pokaż prędkość / wewnętrzny FPS
Toggled Speed Limit = Włącz/wyłącz limit prędkości
Frame Skipping = Porzucanie klatek
[MainMenu]
Credits = Autorzy
Exit = Wyjdź
Load = Wczytaj...
Settings = Ustawienia
[MainSettings]
Audio = Dźwięk
AudioDesc = Dostosuj ustawienia dźwięku
Controls = Sterowanie
ControlsDesc = Kontrolki dotykowe, duże przyciski
Developer = Zaawansowane
DeveloperDesc = Testy CPU, zrzut nast. frame
Graphics = Grafika
GraphicsDesc = Dostosuj ustawienia grafiki
Settings = Ustawienia
System = System
SystemDesc = Ustawienia systemowe
[PSPCredits]
created = Program stworzony przez
license = Wolne Oprogramowanie na licencji GPL 2.0
[Plugin]
Already installed = Mai's Atrac3+ decoder już jest zainstalowany.
Czy chciałbyś pobrać i zainstalować go od nowa?
Back = Wstecz
Download and install = Pobierz i zainstaluj.
Installed Correctly = Plugin Mai Atrac3+ został poprawnie zainstalowany.
Kliknij Wstecz.
More Information = Więcej informacji
Origins are dubious = * Plugin Mai's Atrac3+ decoder jest aktualnie
wymagany w większości gier do wsparcia dźwięku w tle (muzyki), oraz
głosu. Pochodzenie tego kodu stoi pod znakiem zapytania.
Kliknij Więcej informacji aby dowiedzieć się więcej.
SorryNoDownload = Przykro nam, nie można pobrać tego plugina automatycznie
na tej platformie.
To download and install = Aby pobrać i zainstalować plugin Mai's Atrac3+
 naciśnij Pobierz.
[System]
+1 = +1
-1 = -1
Button Pref : X to Confirm = Preferencje przycisków : X aby Potwierdzić
Clear = Wyczyść
Dynarec = Dynarec (JIT)
Enable Cheats = Włącz cheaty
Fast Memory = Szybka pamięć (niestabilne)
Language = Język
Max. No of Recents : = Maksymalna ilość ostatnich gier :
Show Debug Statistics = Pokaż statystyki debugowania.
System Language : = Język systemowy :
System Settings = Ustawienia systemowe
Unlock CPU Clock = Odblokuj zegar CPU
Use O = Użyj O
Use X = Użyj X
